#########################
#                       #
#                       #
#                       #
#                       #
#                       #
#                       #
#                       #
#                       #
#                       #
#                       #
#         00000         #
#         00P00         #
#         00000         #
#         00000         #
#                       #
#                       #
#                       #
#                       #
#                       #
#                       #
#                       #
#                       #
#                      0#
#########################