#########################
#                       #
# ++++++++++ ++++++++++ #
# +                   + #
# + +++++++++++++++++ + #
# +                   + #
# +                   + #
# +    +         +    + #
# +                   + #
# +         +         + #
# +                   + #
# +                   + #
# +   +     P     +   + #
# +                   + #
# +                   + #
# +         +         + #
# +                   + #
# +    +         +    + #
# +                   + #
# +                   + #
# + +++++++++++++++++ + #
# +                   + #
# +++++++++++++++++++++ #
#                      0#
#########################